W - White
G - Green
B - Black
R - Red
U - Blue
WU - Azorius
UB - Dimir
BR - Rakdos
RG - Gruul
GW - Selesnya
WB - Orzhov
UR - Izzet
BG - Golgari
RW - Boros
GU - Simic
GWU - Bant
WUB - Esper
UBR - Grixis
BRG - Jund
RGW - Naya
WBG - Abzan
URW - Jeskai
BGU - Sultai
RWB - Mardu
GUR - Temur
UBRG - Glint-Eye Nephilim
BRGW - Dune-Brood Nephilim
RGWU - Ink-Treader Nephilim
GWUB - Witch-Maw Nephilim
WUBR - Yore-Tiller Nephilim
WUBRG - WUBRG